S2 S2 S2 S2 S2 S2 S2 S2 S2
-- -- -- -- -- -- -- -- --
-- -- -- -- -- -- -- -- --
-- -- -- -- -- -- -- -- --
-- -- -- -- -- -- -- -- --
w1 w1 w1 w1 w1 w1 w1 w1 w1
-- -- -- -- -- -- -- -- --
-- -- -- -- -- -- -- -- --
-- -- -- -- -- -- -- -- --
-- -- -- -- -- -- -- -- --
S2 S2 S2 S2 S2 S2 S2 S2 S2
